-------------------------------------------------------------------------------------------------------------------------------------------------------------------------------------------------------------------------------------------
-------------------------------------------------------------------------------------------------------------------------------------------------------------------------------------------------------------------------------------------
-********************************************************************************************************************************************************************************************************************************----------
-*************************-----------------------**********************************************************************----------------------------------------------************************************************************----------
-*************************-*********************-*********************************************************************-**********888888888888888888888888888888888***-***********************************************************----------
-*************************-*****8888888888888***-********************************************************************-************888888888888888888888888888888888**-***********************************************************----------
-*************************-*****8888888888888***-*********************************************************************-**********888888888888888888888888888888888***-***********************************************************----------
-************************--*****8888888888888***-********************************************************************-***********888888888888888888888888888888888***-***********************************************************----------
-------------------------**********************-----------------------------------------------------------------------***********888888888888888888888888888888888***-**********************************************************-----------
-********************************************************************************************************************************888888888888888888888888888888888***----------------------------------------------------------------------
-*********************************************************************************************************************************************************************************************************************************---------
N000000000000000000000000000000000000000000000000000000000000000000000000000000000000000000000000000000000000000000000000000000000000000000000000000000000000000000000000000000000000000000000000000000000000000000000000000000002---------
N000000000000000000000000000000000000000000000000000000000000000000000000000000000000000000000000000000000000000000000000000000000000000000000000000000000000000000000000000000000000000000000000000000000000000000000000000000002---------
N000000000000000000000000000000000000000000000000000000000000000000000000000000000000000000000000000000000000000000000000000000000000000000000000000000000000000000000000000000000000000000000000000000000000000000000000000000002---------
*************************0000*******************************************************************************************************************************************************0000*****************************************----------
---------****************0000*********************************----------------------------------------------------------------8888888888888888888888888888888888888888888888********0000***********----------------------------------------
********-****************0000*********************************-***************************************************************-8888888888888888888888888888888888888888888888*******0000************-**********************----------------
********-****************0000*********************************-***************************************************************-8888888888888888888888888888888888888888888888*******0000************-**********************----------------														
********-****************0000************88888888888888888888-***************************************************************-******************************************************0000************-**********************----------------
********-****************0000************88888888888888888888-***************************************************************-******************************************************0000************-**********************----------------
********-****************0000************88888888888888888888-***************************************************************-******************************************************0000************-**********************----------------
********-****************0000************88888888888888888888-***************************************************************-**************00000000000000000000000000000000000000000000************-**********************----------------
********-*****8888888****0000************88888888888888888888-***************************************************************-**************00000000000000000000000000000000000000000000***********-**********************-----------------
********-*****8888888****0000************88888888888888888888-***************************************************************-**************00000000000000000000000000000000000000000000***********-**********************-----------------
********-*****8888888****0000*******************************-***************************************************************-***************0000***************************************************-**********************-----------------
********-*****8888888****0000*******************************-***************************************************************-***************0000***************************************************-**********************-----------------
********-*****8888888****0000*******************************-***************************************************************-***************0000*******************888888888888888888888888********-**********************-----------------
********-*****8888888****0000*******************************-***************************************************************-***************00000000000************888888888888888888888888********-**********************-----------------
********-*****8888888****0000*******************************-***************************************************************-***************00000000000************888888888888888888888888********-**********************-----------------
********-****************0000********************************-***************************************************************-8888888*******00000000000************888888888888888888888888********-**********************-----------------
********-****************0000*********XHHHH******************-***************************************************************-8888888*******00000000************************************************-**********************----------------
********-****************0000**********HHHH******************-***************************************************************-8888888****00000000000***************888888888888888888888888********-**********************-----------------
********-****************0000********************************-***************************************************************-8888888****00000000000************************************************--**********************---------------
********-****************0000********************************-***************************************************************-8888888****00000000000************************************************-**********************----------------
********-****************0000********************************-***************************************************************-8888888*******0000*******************888888888888888888888888*********-*****************---------------------
********-****************0000********************************-***************************************************************-8888888*******0000****************************************************-**********************----------------
********-****************0000********************************-***************************************************************-8888888***************************************************************-**********************----------------
********-****************000000000000************************-***************************************************************-8888888***************************************************************-**********************----------------
********-****************000000000000************************-***************************************************************-8888888*****************************************************************-**********************--------------
********-****************000000000000************************-***************************************************************--------------------------------**********************************************-**********************---------
********-************************0000************************--------------------------------***************************************************************-****888888888888888888************************-**********************---------										
********-*****88888888888888*****0000*******************************************************-***************************************************************-****888888888888888888************************-**********************---------
********-*****88888888888888*****0000*******************************************************-***************************************************************-****888888888888888888************************-**********************---------
********-*****88888888888888*****0000*******************************************************-***************************************************************-****888888888888888888************************-**********************---------
********-*****88888888888888*****0000*******************************************************-***************************************************************-****888888888888888888************************-**********************---------
********-*****88888888888888*****0000*******************************************************-***************************************************************-****888888888888888888************************-**********************---------
********-*****88888888888888*****0000************************88888888888888888888888********-***************************************************************-****888888888888888888************************-**********************---------
********-************************0000************************88888888888888888888888********-***************************************************************-****888888888888888888************************-**********************---------
********-************************000000000000000000000000****88888888888888888888888********-***************************************************************-****888888888888888888************************-**********************---------
********-************************000000000000000000000000****88888888888888888888888********-***************************************************************-************************************************-**********************-------
********-************************000000000000000000000000****8888888888888888888888********-***************************************************************-************************************************-**********************--------
********-****************************************************8888888888888888888888********-***************************************************************--------------------------------------------------------------------------------
********----------------------------------------------------------------------------------------------------------------------------------------------------------------------------------------------------------------------------------1